o**X*X*X**
oXXX*X*X*X
ooo*******
XXoXXXXXXX
oooX******
oXXXXX*XXX
o**X******
oXXX*XXXXX
oooooooX*X
*X*X*Xoooo