oX*****X**
oX*XXX*X*X
oooooX****
XXXXoXXXXX
***XoX****
XX*XoXXX*X
****o****X
XX*XoXXX*X
***XoooXXX
*X*X*Xoooo