oX*****X**
oX*XXX*X*X
oooooX****
XXXXoXXXXX
***XoX****
XX*XoXXX*X
****o****X
XX*XoXXXXX
***XoooX*X
*X*X*Xoooo